####>~~~~~~~~~~~~~~~~~~~~~~~~~~~~~~~~~~~~~~~~~~~~~~~~~~~~~~~~~~~~~~~~~~~~~~~~~~~~~~~~~~~~~~~~~
@@###^^^^^^^^^^^^^^^^^^^^^^~~~~~~~~~~~~~~~~~~~~~~~~~~~~~~~~~~~~~~~~~~~~~^^~~~~~~~~~~~~~~~~~~~~
@@@########################>~~~~~~~~~~~~~~~~~~~~~~~~~~~~~~~~~~~~~~~~~~<####>~~~~~~~~~~~~~~~~~~
@@@@@@@################____~~~~~~~~~~~~~~~~~~~~~~~~~~~~~~~~~~~~~<##^^^#######^^^#>~~~~~~~~~~~~
@@@@@@@@@@@@#########>~~~~~~~~~~~~~~~~~~~~~~~~~~~~~~~~~~~~~~~~<####################>~~~~~~~~~~
@@@@@@@@@@@@@@#########>~~~~~~~~~~~~~~~~~~~~~~~~~~~~~~~~~~~~<##################>~~~~~~~~~~~~~~
@@@@@@@@@@@@@@@@@#######>~~~~~~~~~~~~~~~~~~~~~~~~~~~~~~~~~~~<#############>~~~~~~~~~~~~~~~~~~~
@@@@@@@@@@@@@@@@@@@######>~~~~~~~~~~~~~~~~~~~~~~~~~~~~~~~~~~<###############>~~~~~~~~~~~~~~~~~
@@@@@@@@@@@@@@@@@@@@@@@###>~~~~~~~~~~~~~~~~~~~~~~~~~~~~~~~~<#################>~~~~~~~~~~~~~~~~
@@@@@@@@@@@@@@@@@@@@@@@#####>~~~~~~~~~~~~~~~~~~~~~~~~~~~~~~<#################>~~~~~~~~~~~~~~~~
@@@@@@@@@@@@@@@@@@@@@@@######>~~~~~~~~~~~~~~~~~~~~~~~~~~~~~<#################>~~~~~~~~~~~~~~~~
@@@@@@@@@@@@@@@@@@@@@@@######>~~~~~~~~~~~~~~~~~~~~~~~~~~~~~<#################>~~~~~~~~~~~~~~~~
@@@@@@@@@@@@@@@@@@@@@@@######>~~~~~~~~~~~~~~~~~~~~~~~~~~~~~<#################>~~~~~~~~~~~~~~~~
@@@@@@@@@@@@@@@@@@@@@@@@@@@#####>~~~~~~~~~~~~~~~~~~~~~~~~~~~~~<#############>~~~~~~~~~~~~~~~~~
@@@@@@@@@@@@@@@@@@@@@@@@@@@@#######>~~~~~~~~~~~~~~~~~~~~~~~~~~~~~<#######>~~~~~~~~~~~~~~~~~~~~
@@@@@@@@@@@@@@@@@@@@@#########>~~~~~~~~~~~~~~~~~~~~~~~~~~~~~~~~~~~~~___~~~~~~~~~~~~~~~~~~~~~~~